腌臜   肮脏   污秽	形容词
哀求  恳求 乞求 央求	动词
矮子 矬子 侏儒	名词
爱戴  敬爱	动词
爱好  嗜好	动词 名词
爱护  爱惜  珍惜	动词
爱慕  倾慕 羡慕 仰慕	动词
安顿 安放 安排 安置	动词
安全 平安	形容词
安闲 安逸	形容词
安葬 埋葬	动词
按 照	介词
按期 按时	副词
按照 依照 遵照	介词
暗藏 私藏 窝藏 隐藏	动词
暗害 暗杀 暗算	动词
翱翔  飞翔	动词
拗口  绕嘴	形容词
傲慢 高傲 高慢 骄傲 骄矜 骄慢	形容词
奥秘 秘密	名词
奥妙  玄妙	形容词
懊悔 懊恼	动词
懊悔 忏悔 后悔 悔限	动词
懊丧 沮丧 颓丧	形容词
巴不得 恨不得 恨不能	动词
把持 操纵 控制	动词
把握  掌握	动词
霸道  蛮横  强横	形容词
霸占  强占	动词
白茫茫  白蒙蒙	形容词
摆设  陈列  陈设	动词
摆脱 解脱	动词
败坏 破坏	动词
败类  丑类	名词
败露 暴露 显露	动词
败落 没落 衰败 衰落	动词
拜访 拜会 拜见 拜谒	动词
拜访 访问 看望	动词
拜服 佩服 折服	动词
拜托 托付 委托	动词
版布 公布	动词
搬弄 拨弄 播弄 离间 调拨 调唆 挑拨 挑唆	动词
办法 措施	名词
伴随  伴同  陪伴  陪同  随同	动词
帮派  宗派	名词
帮凶  鹰犬  爪牙  走狗  走卒	名词
帮助  协助	动词
榜样  标兵  模范	名词
包含 包涵 包括 包罗	动词
宝贵 珍贵	形容词
保持  维持	动词
保存 保留	动词
保护 保卫 捍卫	动词
保暖 保温	动词
保障  保证	动词 名词
饱满  丰满	形容词
抱负  理想  志向	名词
抱歉 道歉	动词
抱怨  埋怨	动词
暴发 爆发	动词
暴露 揭露	动词
暴虐 残暴 残酷 残忍	形容词
暴徒  歹徒	名词
暴行 丑行 恶行 兽行	名词
卑鄙  卑劣	形容词
卑贱 卑微 卑下 低贱 低微 微贱 下贱	形容词
悲哀  悲伤  悲恸  悲痛  沉痛	形容词
悲观  失望	失掉信心常连用成“悲观失望”
悲凉  凄凉	形容词
备受 倍受	动词
背静 僻静	形容词
背离  违背  违反  违犯 违抗	动词
背叛 叛变 叛离	动词
背时 背运 倒霉 倒楣 倒运 倒灶 晦气	形容词
被 给 叫 教 让	介词
奔波 奔忙 奔走	动词
奔驰 奔腾	动词
本来 原来	副词
本领 本事	名词
本相 原形 真相	名词
本质  实质 性质	名词
笨拙  愚笨	形容词
甭  不必  不用  无须  毋庸	副词
比较 对比 对照	动词
比美 媲美	动词
比如  例如	动词
比如  譬如	动词
比赛  竞赛	动词
比喻 譬喻	动词兼名词
鄙薄 鄙视 鄙夷	动词
鄙弃 唾弃 厌弃	动词
鄙视 藐视 蔑视 轻视	动词
毕命 毙命	动词
毕竟  究竟	副词
弊病  弊端	名词
璧还 返还 奉还 归还 交还 送还 退还 掷还	动词
边陲 边疆 边境	名词
边际 边沿 边缘	名词
编造 捏造 伪造 臆造	动词
鞭策 督促	动词
鞭挞 抨击	动词
变故 事端 事故	名词
便当  便利  方便	形容词
遍及 普及	动词
辨别  鉴别	动词
辨别 辨认 辨识	动词
辩白 辩护 辩解	动词
辩论 争辩 争论 争议 争执	动词
标记 标志 标识 标帜	名词
标明  表明	动词
标题 题目	名词
标致 好看 美丽 漂亮	形容词
标准  尺度	名词
表白  表示	动词
表露 流露 透露 吐露	动词
表现 体现	动词
表扬 表彰	动词
别称  别名	名词
别致 雅致	形容词
宾客	名词
濒临  濒于	动词
摈弃  屏弃  摒弃  放弃  抛弃	动词
兵 士兵 战士	名词
秉性  禀性	名词
病人 患者	名词
剥削  盘剥	动词
驳斥  反驳  批驳	动词
博得  赢得	动词
搏斗 格斗  角斗	动词
薄弱 脆弱 软弱	形容词
补贴  贴补	动词
哺育  抚育	动词
不比  不如	动词
不单 不但 不光  不仅 不只	连词
不得了  了不得	形容词
不凡 超凡 非凡	形容词
不管 不论 无论	连词
不管  即使 尽管	连词
不过 但 但是 可 可是 然而	连词
不过 只是	副词 连词
不如  莫如	动词
不韪 错处 过错 过失	名词
布告 公告 通告	名词
步调  步伐	名词
部队 队伍 军队	名词
部分 局部	名词
部门  单位	名词
部署  布置	动词
猜疑 狐疑 怀疑 疑惑  疑心	动词
才  方才	副词
才干 才华 才能 才智	名词
材料  资料	名词
财产  财富	名词
采纳 采取 采用	动词
参加 参与 参预 加入	动词
残杀  杀害	动词
惨白  苍白	形容词
灿烂 璀璨 绚烂	形容词
仓促 仓卒 仓猝 匆匆 匆促 匆卒 匆猝 匆忙	形容词
苍茫 迷茫 渺茫	形容词
操守 节操 名节 气节	名词
操心  费心	动词
操行  品行	名词
草率 马虎 马糊 轻率	形容词
侧重 偏重 注重 着重	动词
策动  策划	动词
策略 政策	名词
曾经  已经	副词
差别  分别  区别	名词
差错 错误 讹误 过错 过失 谬误 失误	名词
查访 察访 访查 访察	动词
查问  盘问	动词
察觉  觉察	动词
刹那  俄顷  片刻  片时  顷刻  霎时  瞬息  须臾  一会儿	名词
诧异 骇异 惊诧 惊奇 惊讶 惊异	形容词
掺和 搀和 掺杂 搀杂	动词
缠磨 纠缠 歪缠	动词
缠绕 缭绕 旋绕 萦绕	动词
产生  发生	动词
谄媚  献媚	动词
铲除 革除 根除 剪除  清除	动词
颤抖 打战 打颤 哆嗦 发抖 战抖 战栗 颤栗	动词
昌盛  兴盛	形容词
猖獗 猖狂 疯狂	形容词
长处 优点	名词
长久 长远 久远 悠久	形容词
长逝 辞世 故去 故世 过世 弃世 去世 逝世  死 死亡 亡故 下世 谢世	动词
常常  经常  时常	副词
常规 惯例 通例	名词
常识  知识	名词
场  出  台	量词
场合 场所	名词
敞亮  豁亮	形容词
怅惘  惆怅	形容词
畅快  痛快	形容词
畅通 通畅	形容词
倡导 提倡	动词
倡议 创议	动词 名词
抄袭 剿袭  因袭	动词
巢穴  敌巢  匪巢  匪窝  匪穴  老巢  窝巢	名词
朝  往  向	介词
嘲讽 嘲弄 嘲笑	动词
潮湿  湿润	形容词
撤离  撤退 退却	动词
撤销 撤消 取缔 取消	动词
尘埃 尘土 灰尘 灰土	名词
沉  重	形容词
沉寂 沉静 寂静	形容词
沉浸  沉醉  陶醉	动词
沉沦  沉湎  沉溺	动词
沉没  淹没	动词
沉默 缄默	动词
沉思 深思 寻思	动词
沉稳 持重 稳当 稳健 稳妥 稳重	形容词
沉重 繁重	形容词
陈腐  陈旧	形容词
陈迹 遗迹	名词
陈述 陈说 陈诉 述说 诉说 叙述 叙说	动词
晨光 晨曦	名词
衬托 烘托 陪衬	动词
称号 称呼 称谓	名词
称颂 称誉 称赞	动词
成功  胜利	动词
成果 结果 效果	名词
成绩  成就	名词
成见  偏见	名词
成立  建立	动词
呈现  浮现	动词
诚恳 诚实 诚挚	形容词
诚心  诚意  真心	名词
承担 承当  担当  担负  担任  负担	动词
承继 承袭 继承	动词
程度 水平 水准	名词
澄澈 澄彻 澄清	形容词
澄清 廓清	动词
嗤笑 耻笑 讥笑 取笑 讪笑 笑话	动词
驰名  闻名  著称	动词
迟钝 鲁钝 愚钝	形容词
迟疑 踌躇 踌蹰 犹豫	形容词
持续  继续	动词
斥责 叱责 责备 指斥 指责 指摘	动词
赤诚  真诚	形容词
炽热  火热  酷热  炎热  灼热	形容词
充斥  充满  充溢	动词
充当  充任	动词
充分  充沛  充实  充裕  充足	形容词
充数  凑数  顶数	动词
冲破  突破	动词
憧憬 神往 向往	动词
重复 反复	动词
重新 从新	副词
崇拜  崇敬	动词
崇高  高尚	形容词
崇洋  媚外	动词
宠爱  溺爱  钟爱	动词
仇恨 愤恨 痛恨 憎恨	动词
稠密  茂密  浓密	形容词
丑恶  丑陋	形容词
瞅  盯  看  瞥  瞧  望	动词
出发 登程 动身 启程 起程  起身 上路	动词
出卖  叛卖	动词
出名 有名 知名 著名	形容词
出色  精彩 精采	形容词
出生 出世 诞生 降生	动词
出现  涌现	动词
初级 低级	形容词 属性词 
处罚  处分	动词 名词
处境  地步  境地  天地  田地	名词
储备 储藏 储存 储蓄 贮藏	动词
储藏  蕴藏	动词
储存 存储 存贮 贮存	动词
处处 到处 各处 各地	副词
触犯 得罪 冒犯	动词
矗立 耸立 挺立 屹立	动词
传播 传布	动词
传染  感染	动词
传授 教授	动词
串通  勾结	动词
闯将 干将 猛将	名词
创办  开办	动词
创立 建立 树立	动词
创造 发明	 动词
创造  创制  创作	动词
吹捧  吹嘘	动词
垂死  垂危	动词
锤炼 锻炼 磨炼	动词
纯粹 纯正	形容词
纯洁  纯净	形容词 动词
纯朴  淳朴  淳厚 纯厚、醇厚   朴质  质朴	形容词
绰号 诨号 浑号、混号  诨名 浑名、混名  外号	名词
词  辞	名词
词  词汇	名词
词典  辞典	名词
辞别  辞行  道别  告别  告辞	动词
慈爱  慈和  慈善  慈祥  仁慈	形容词
此外  另外	连词
次第  次序  顺序	名词 副词
伺候 服侍 伏侍、服事  侍奉 侍候 事奉	动词
刺目  刺眼	形容词
赐予 赐与   付与 付予   赋予  给以  给予 给与   授予  予以	动词
聪慧 聪敏 聪明 聪睿 聪颖 伶俐	形容词
从来 历来 向来	副词
从前 过去 往常 先前 以前 以往 已往 原先 早年 早先 之前	名词
从属  附属  隶属	动词
凑巧 赶巧 碰巧	表示行为正遇着某事或正在某时常做状语
粗暴 粗鲁 粗卤  粗野	形容词
粗犷  豪放	形容词
粗俗 庸俗	形容词
粗心  大意  马虎 马糊   疏忽	形容词
簇新  崭新	形容词
簇拥 蜂拥	动词
窜改  篡改	动词
摧残  摧毁	动词
答应 容许 许可 允许 准许	动词
达到 到达 抵达	动词
答复 回答 回复	动词
打扮 装扮 妆扮	动词
打击  攻打	动词
打搅 打扰 捣乱 烦扰 干扰 搅乱 搅扰 扰乱 骚扰	动词
打劫 抢夺 抢劫 抢掠	动词
打量  端详	动词
打算 盘算 企图	动词
打听 了解 探问	动词
大半  多半	数词 副词
大抵 大概 大约 大致	副词
大都  大多	副词
大方  慷慨	形容词
大纲 纲要 提纲	名词
大举  大力  大肆	副词
呆板 死板	形容词
代替 取代 替代 替换	动词
带  戴	动词
带领 带头 领头 率领	动词
担心  担忧	动词
单调  枯燥	形容词
耽搁 担搁  耽误	动词
胆寒 胆怯	形容词
诞辰 华诞 生日 寿辰	名词
淡薄  淡漠	形容词
当  在	介词
当即  即刻  即时  立即  立刻  立时  马上	副词
当中  之间  中间	名词
党徒 党羽	名词
祷告  祈祷	动词
到底  终于	副词
倒  却	副词
盗  窃  偷	动词
盗窃 偷盗 偷窃	动词
道  路	名词
道路 途径	名词
得当  恰当  切当  确当  适当  妥当	形容词
得到 获得 取得	动词
得意  惬意	形容词
等待 等候 期待	动词
低沉  消沉	形容词
低廉 廉价 便宜	形容词
的确  确实  实在  委实  着实	副词
诋毁 毁谤	动词
抵偿 赔偿	动词
抵挡 抵抗 抵御	动词
谛听 聆听 倾听	动词
缔结 订立 签订	动词
颠覆 推翻	动词
点  些	量词
典范  典型  范例	名词
典雅 高雅 儒雅 文雅 娴雅 闲雅	形容词
电脑 计算机	名词
玷污  污染	动词
惦记 惦念 挂念 怀念 思念 想念	动词
叮咛 叮嘱 嘱咐	动词
顶  最	副词
订  定	动词
订金 定金	名词
订正 修订 修改 修正	动词
动乱 骚乱	动词
动听 好听 悦耳	形容词
动用  挪用	动词
动员  发动	动词
恫吓  恐吓  威吓	动词
都  全	副词
抖擞 振奋 振作	动词
陡峭  峻峭	形容词
斗争 奋斗	动词
毒辣 狠毒	形容词
独裁  专制	动词
独创  开创  首创	动词
独特  奇特	形容词
读  念	动词
渎职  失职	动词
堵塞  阻塞	动词
睹 观 见 览 视	动词
度过  渡过	动词
短促 短暂 急促	形容词
断定  确定	动词
断绝  隔绝	动词
队列  队伍	名词
对 双	量词
对  对于	介词
多会儿  几时	代词
夺取 猎取	动词
夺取 抢夺	动词
躲避 回避 逃避	动词
躲懒 偷懒 偷闲	动词
堕落 腐化 蜕化	动词
讹诈  敲诈	动词
扼杀 抹杀 抹煞	动词
扼要  简明	形容词
恶棍  恶魔	名词
恶果 后果	名词
遏止  遏制	动词
恩赐  赏赐	动词 名词
恩德 恩惠 恩情	名词
儿  子	后缀
儿童 孩提 孩童 孩子 娃娃 小儿 小孩儿	名词
而后  尔后	连词
而况 何况 况且	连词
耳闻  听说	动词
耳语 私语	动词
二  两	数词
发表  发布  公布  宣布  宣告	动词
发达 兴盛 兴旺	形容词
发奋 发愤 奋发	动词
发觉  发现	动词
发掘  挖掘	动词
发扬  弘扬 宏扬	动词
翻悔 反悔	动词
烦恼  苦恼	形容词
烦躁 急躁 焦躁	形容词
繁华 繁荣	形容词
繁忙  忙碌	形容词
繁杂 烦杂  复杂 庞杂	形容词
反攻 反扑	动词
反思 反省	动词
反应 反映	动词 名词
范畴  范围  领域	名词
方法  方式	名词
防守  防卫	动词
妨碍 妨害  阻碍	动词
仿佛 好像 似乎	副词 动词
仿造  仿制	动词
放荡 放浪 放肆 放纵	形容词
放任 放手	动词
非常  十分	副词
非常  异常	副词 形容词
肥  胖  肥胖	形容词
肥美 肥沃	形容词
废除 解除 破除	动词
费劲  费力	形容词
费心  劳驾	动词
分辨  分别  区别  区分	动词
分别  分离  离别	动词
分明  鲜明	形容词
分派  分配	动词
纷繁 纷纷 纷纭	形容词
纷乱 混乱 凌乱 零乱  紊乱 杂乱	形容词
粉饰 修饰 装饰	动词
分外 格外	副词
愤激 愤慨 愤懑 愤怒	形容词
丰富 丰厚 丰盛 丰硕	形容词
风采 丰采  风度 风韵 丰韵  风姿 丰姿	名词
风景 景色 景物 景致	名词
风气 风尚 风俗	名词
风行 流行 盛行	动词
锋利  锐利  犀利	形容词
讽嘲 讽刺 讥嘲 讥刺  讥讽  讥诮  讥笑	动词
奉承 恭维 恭惟	动词
肤浅  浮浅  浅薄	形容词
敷衍 应付	动词
扶养 抚养 抚育 赡养	动词
扶植 扶助	动词
扶助  辅助	动词
拂晓 黎明 凌晨 破晓	名词
服从 顺从 听从 依从 遵从	动词
服气 佩服 信服 折服	动词
符合 适合	动词
俯瞰 俯视 鸟瞰	动词
辅助  协助	动词
腐败 腐朽	形容词
腐化  腐烂	动词
腐蚀 侵蚀	动词
复辟 复旧	动词
富丽  华丽	形容词
富强  强盛	形容词
覆盖 笼罩 遮盖	动词
改变  转变	动词
改革  改造	动词
改进 改良 改善	动词
改正  矫正  纠正	动词
概括  综合	动词
干脆  索性	副词
干净 洁净 清洁	形容词
干枯 枯干 枯槁 枯萎	形容词
干涉  干预 干与	动词
杆  竿	名词
尴尬 窘迫 狼狈 难堪 为难 作难	形容词
赶紧 赶快 赶忙 急忙 连忙	副词
感动  激动	动词
感激 感谢 敬谢 鸣谢 谢谢	动词
感觉  觉得	动词
感冒  伤风	名词 动词
感情  情感	名词
干  搞  做	动词
干劲  劲头	名词
刚好 刚巧 可巧 偏巧 恰好 恰恰 恰巧 正好	副词
刚强  倔强	形容词
刚毅  坚毅	形容词
高潮  热潮	名词
高大 魁梧	形容词
高速  快速	形容词
高兴 喜悦 愉快	形容词
告发 检举 举报 举发	动词
割据 盘踞 盘据	动词
歌唱 歌颂 歌咏	动词
隔阂  隔膜	名词 形容词
各 每	指示代词
给  替  为	介词
给以  加以	动词
根本 基本	名词 形容词
根底 根基 基础	名词
根据 依据	介词 名词 动词
跟  和  及  暨  同  以及  与	连词 介词，
耿介  耿直 梗直、鲠直   正直	形容词
更加 越发 愈加	副词
工厂  工场	名词
工夫  功夫  时间	名词
工整 整齐	形容词
公道 公平 公正	形容词
公民  国民 人民	名词
公事 公务	名词
公约  契约  条约	名词
功绩  功旁  功勋	名词
功绩 伟绩 业绩	名词
功课 课程	名词
攻击 进犯 进攻 进击	动词
攻击 抨击	动词
供给 供应	动词
供养 赡养	动词
巩固  坚固  牢固 稳固	形容词
共同 一道 一起 一同	副词
供认 招供 招认	动词
勾搭  勾结	动词
勾通  沟通	动词
勾引  引诱	动词
构造  结构	名词
购买  购置  置办	动词
估计 估量 估摸	动词
孤单 孤独 孤立	形容词
古怪  奇怪	形容词
鼓动  煽动 扇动	动词
鼓励 鼓舞 激励 勉励	动词
固执  顽固  顽强	形容词
故乡  家乡	名词
故意  蓄意	副词
怪 挺	副词
关怀 关切 关心 关注	动词
关键  症结	名词
关系  联系	名词
观察 视察	动词
观点 见解 看法	名词
观赏  欣赏	动词
管理  管束  管制	动词
贯穿  贯串	动词
灌输  灌注  贯注	动词
光彩 光华 光辉 光芒	名词
光顾  惠顾	动词
光辉 辉煌	形容词
光景  情景	名词
光临  莅临	动词
光荣  荣誉	名词
光阴  年代  年头儿  年月  时光  岁月	名词
广博  渊博	形容词
广泛 普遍	形容词
广阔  宽阔  辽阔	形容词
规划  计划	名词 动词
规矩 规则	名词
瑰宝  珍宝	名词
诡辩 狡辩	动词
诡计  鬼计  阴谋	名词
贵宾  贵客  嘉宾 佳宾   上宾	名词
国度  国家	名词
果敢 勇敢	形容词
果然  果真	副词 连词
过程  历程	名词
过度  过分  过火  过甚  过头	形容词
还  又	副词
害怕  惧怕  畏惧	动词
含义 涵义、函义    含意 涵意	名词
喊叫  呼叫  呼喊  叫喊  叫唤  叫嚷  叫嚣  呐喊	动词
豪放  豪迈	形容词
豪华  奢华	形容词
豪情  激情	名词
耗费  消费  消耗	动词
浩大  盛大	形容词
合作  协作	动词
何必  何苦	副词
和蔼  和气	形容词
核心  中心  重心	名词
黑暗  昏暗	形容词
宏大 巨大 庞大 伟大	形容词
宏伟 雄伟 雄壮	形容词
洪亮 宏亮  嘹亮 响亮	形容词
哄骗 诓骗 欺骗 诱骗 诈骗	动词
后辈 后代 后嗣 后裔 苗裔 子孙	名词
呼唤 招呼 招唤 召唤	动词
呼啸 咆哮	动词
忽略 疏忽	动词
忽然 猛然 突然 骤然	副词
忽视 漠视 无视	动词
互相 相互	副词
滑稽 诙谐 幽默	形容词有趣而引人发笑的可以形容言语
化妆 化装	动词
怀念 缅怀 追念	动词
欢畅 欢快 欢乐 欢喜 欢欣	形容词
环顾 环视	动词
环绕 围绕	动词
幻想 空想 梦想	 一 动词 二 名词
唤醒 提醒	动词
涣散 散漫	形容词
荒诞 荒谬 荒唐	形容词
晃荡 晃动 晃悠	动词
挥霍 浪费 靡费 糜费  糟蹋 糟踏、糟塌	动词
回顾 回忆	动词
毁坏 破坏 损坏	动词
会  能	助动词
会 会议	名词
会合 汇合	动词
会见 会面 会晤 见面	动词
会见 接见	动词
昏厥 昏迷 休克 晕厥	动词
浑浊 混浊 溷浊  污浊	形容词
混充 假充 假冒 冒充	动词
混合 混杂	动词
混同 混淆	动词
活动 运动	动词 名词
活力 活气 生气	名词
伙伴 同伴	名词
或则 或者	连词
祸害 祸患	名词
几乎 简直	副词
机会 机遇 机缘 际遇 时机	名词
机警 机灵 机伶  机智	形容词
机密 秘密	形容词 名词
机能 性能	名词
积累 积蓄	动词
激烈 剧烈 猛烈 强烈	形容词
吉利 吉庆 吉祥	形容词
汲取 吸取 吸收	动词
即便 即或 即令 即使 就是 就算 哪怕 那怕  纵令 纵然 纵使	连词
急迫 急切 紧迫 迫切 急忙 焦急	形容词
集团 团体	名词
记录 纪录  记载	动词
伎俩 手段 手法 手腕	名词
技能 技巧 技术	名词
继续 连续 联续	动词
寂寥 寂寞	形容词
加强 增强	动词
佳作 杰作	名词
家畜 牲畜	名词
家眷 家属	名词
假装 伪装 装作	动词
价格 价钱 价值	名词
驾驶 驾驭 驾御	动词
尖刻 刻薄 苛刻	形容词
奸险 阴险	形容词
奸笑 狞笑	动词
歼灭 消灭	动词
坚定 坚决	形容词
坚苦 艰苦	形容词
坚强 顽强	形容词
坚忍 坚韧	形容词
坚信 确信 深信	动词
监督 监视	动词
俭朴 俭省 节俭	形容词
检查 检验	动词
减低 降低	动词
减弱 削弱	动词
简单 简略	形容词
简洁 简捷 简截	形容词
简练 精练 精炼	形容词
间隙 空隙	名词
建设 建造 建筑	动词
建议 提议	动词 名词
渐渐 逐步 逐渐	副词
践踏 蹂躏	动词
将来 未来	时间名词
讲   说	动词
奖章 勋章	名词
交代 交待  坦白	动词
交换 交流	动词
交谈 攀谈 谈话	动词
焦急 焦躁	形容词
骄傲 自豪	形容词
侥幸 儌倖、徼倖  幸运	形容词
狡猾 狡滑  狡黠 狡诈	形容词
矫健 矫捷	形容词
脚迹 脚印 足迹 足印	名词
教导 教诲 教训 教育	动词
教室 课堂	名词
教唆 嗾使 唆使 指使	动词
接济 救济 周济 赒济	动词
接见 召见	动词
接连 连接 联接  联结 连结  衔接	动词
接纳 接收	动词
接收 接受	动词
揭发 揭穿 揭露 揭破	动词
揭示 显示	动词
节省 节约	动词
杰出 卓绝 卓越	形容词
结余 盈余 赢余	动词 名词
解释 说明	动词
界限 界线	名词
紧急 紧迫 紧张	形容词
紧要 要紧	形容词
谨慎 小心	形容词
进步 先进	形容词
禁止 制止 阻止	动词
经过 通过	动词
经历 阅历	动词 名词
精华 菁华  精髓	名词
精美 精致	形容词
精辟 透辟	形容词
精确 准确	形容词
精深 精湛	形容词
精心 细心 用心 专心	形容词
景仰 敬仰 瞻仰	动词
警告 正告	动词
警戒警惕	动词
竟然 居然	副词
敬佩 敬仰 敬重	动词
静穆 肃穆	形容词
纠合 鸠合  纠集 鸠集	动词
就手 顺手 随手	副词
就义 捐躯 舍身 牺牲 献身	动词
拘谨 拘泥 拘束	形容词
拘束 束缚 约束	动词
局面  局势	名词
举办 举行	动词
举动 行动 行径 行为	名词
巨人 伟人	名词
具备 具有	动词
据说 听说	动词
聚积 聚集	动词
眷恋 留恋 迷恋 依恋	动词
决  绝	副词
决定 决议	名词
决裂 破裂	动词
决心 信念 信心	名词
诀窍 窍门	名词
抉择 挑选 选择	动词
觉悟 觉醒	动词
绝望 失望	动词
均衡 平衡	形容词
开端 开始 开头 起头	名词
开发 开垦	动词
开朗 爽朗	形容词
开辟 开拓	动词
开展 展开	动词
看见 瞥见	动词
考查 考察 考核	动词
考虑 斟酌	动词
靠近 靠拢	动词
可耻 羞耻	形容词
可靠 牢靠	形容词
可惜 痛惜 惋惜	动词 形容词
可以 能够	助动词
渴望 盼望 期望 希望 想望	动词
克复 收复	动词
克制 抑制	动词
刻画 刻划  描画 描绘 描述 描写	动词
恳切 殷切	形容词
坑害 陷害	动词
空洞 空泛	形容词
空气 气氛	名词
恐怖 恐惧	形容词
空暇 空闲 闲空 闲暇	名词
口气 口吻	名词
苦楚 苦处	名词
苦寒 酷寒 严寒	形容词
苦痛 痛楚 痛苦	形容词
酷爱 热爱	动词
酷暑 盛暑 盛夏 炎暑 炎夏	名词
夸大 夸张	动词
夸奖 夸耀	动词
快活 快乐	形容词
宽敞 宽广 宽阔	形容词
宽容 宽恕	动词
款待 招待	动词
亏本 赔本 折本 蚀本	动词
岿然 巍然	形容词
窥视 窥伺	动词
困惑 迷惑 疑惑	动词 形容词
扩充 扩大 扩展 扩张	动词
阔绰 阔气	形容词
拉拢 笼络	动词
来源 起源	名词 动词
谰言 流言 谣言	名词
懒虫 懒汉	名词
懒惰 懒散	形容词
滥用 乱用	动词
浪费 糟践 糟蹋 糟踏、糟塌  作践	动词
劳顿 劳苦 劳累 劳碌	形容词
牢骚 怨言	名词
老  总	副词
乐  笑	动词
乐趣 趣味 兴趣	名词
乐意 愿意	动词
冷淡 冷酷 冷漠	形容词
冷静 镇定 镇静	形容词
冷落 冷僻 冷清	形容词
礼拜 星期	名词
礼品 礼物	名词
理解 了解	动词
力量 力气 气力	名词
利弊 利害	名词
利落 利索	形容词
利用 应用 运用	动词
连绵 联绵  绵延 蜿蜒	山脉等连续不断
连续 陆续	事物或行为相继出现或进行
联络 联系	动词 名词
廉洁 廉明 廉正 清廉	形容词
脸 脸蛋儿 脸庞 面孔 面庞 面容 容貌 容颜 相貌 长相	名词
脸色 神色	名词
良好 优良 优秀 优异	形容词
凉快 凉爽	形容词
粮食 食粮	名词
亮丽 靓丽	形容词
谅解 体谅 原谅	动词
疗养 休养	动词
瞭望 眺望 遥望 远眺 远望 远瞩 瞻望	动词
列举 罗列	动词
烈士 先烈	名词
邻近 临近	动词
灵便 灵活 灵敏 灵巧	形容词
领导 领袖 首领 首脑 首长	名词
领导 引导 指导	动词
领会 领略 领悟	动词
领有 拥有	动词
溜达 蹓跶  漫步 散步	动词
留神 留心 留意	动词
流畅 流利	形容词
流窜 逃窜	动词
流荡 流浪 流离 流落 漂泊 飘泊	动词
流派 派别 派系 宗派	名词
流失 流逝	动词
流亡 逃亡	动词
隆冬 穷冬 深冬 严冬	名词
漏洞 马脚 破绽	名词
鲁莽 卤莽  冒失 轻率	形容词
路程 路途 途程 行程	名词
路径 路子 门道 门径 门路 途径 蹊径	名词
旅行 旅游	动词
屡次 屡屡 一再	副词
履行 实行 执行	动词
掠夺 掠取 抢夺	动词
轮番 轮流	副词
落后 落伍	动词
吗  嘛	助词
买卖 生意	名词
卖弄 显示 炫耀	动词
蛮横 野蛮	形容词
满怀 满腔	名词 动词
满意 满足 中意	动词
谩骂 咒骂	动词
漫游 周游	动词
毛病 缺点 缺欠 缺陷	名词
茂盛 旺盛	形容词
美满 圆满	形容词
蒙蔽 蒙哄 蒙混	动词
蒙眬 矇眬  朦胧	形容词
蒙受 受到 遭到 遭受	动词
密切 亲密	形容词
免得 省得 以免	连词
腼腆 靦觍  扭捏 忸怩	形容词
面对 面临	动词
面孔 面貌 面目	名词
苗条 修长	形容词
渺茫 缥缈 飘渺、漂渺	形容词
渺小 藐小 微小	形容词
灭亡 衰亡 死亡 消亡	动词
敏捷 敏锐	形容词
名 名称 名目 名字	名词
名气 名声 名望 名誉	名词
明白 清楚	形容词 动词
明澈 明净 清澈 清彻	形容词
明朗 明亮	形容词
明丽 明媚	形容词
明晰 清楚 清晰	形容词
明显 鲜明 显著	形容词
摸索 探求 探索	动词
模仿 摹仿  模拟 摹拟	动词
摩登 入时 时髦 时新	形容词
陌生 生疏	形容词
莫非 难道	副词
默默 悄悄	副词
牟取 谋取	动词
谋害 谋杀	动词
木材 木柴 木料	名词
目标 目的 宗旨	名词
乃至 甚至	连词
耐烦 耐心	形容词
耐心 耐性	形容词 名词
难过 难受	形容词
内幕 内情	名词
年纪 年龄 年事 年岁 岁数	名词
年青 年轻	形容词
凝集 凝结 凝聚	动词
凝视 注视	动词
纽带 桥梁	名词
浓厚 深厚	形容词
怒吼 咆哮	动词
暖和 温和 温暖	形容词
虐待 迫害	动词
挪动 移动	动词
诺言 誓言	名词
懦弱 软弱 柔弱	形容词
偶尔 偶而  偶然	副词 形容词
拍摄 拍照 摄像 摄影 照相 照像	动词
排斥 排挤	动词
徘徊 彷徨 旁皇	动词
派 派遣	动词
盘剥 榨取	动词
庞大 硕大	形容词
泡制 炮制	动词
培养 培育 培植	动词
澎湃 汹涌	动词
批判 批评	动词
疲惫 疲乏 疲倦 疲劳	形容词
痞棍 痞子	名词
偏向 倾向	名词 动词
翩翩 翩跹	形容词
片段 片断  断片	名词
骗局 圈套	名词
漂泊 飘泊  漂流 飘流	动词
漂浮 飘浮  轻浮	形容词
贫穷	形容词
贫寒 贫苦 贫困 贫穷 穷苦 穷困	形容词
品德 品格 品性 品质	名词
平常 平凡	形容词
平常 平日 平时 平素 素常 素日	名词
平淡 平庸	形容词
平息 停息	动词
评论 评议	动词
迫害 陷害	动词
朴实 朴素	形容词
普通 一般	形容词
凄惨 凄凉	形容词
期间 时代 时间 时期	名词
期求 祈求 乞求 企求	动词
欺负 欺凌 欺侮 欺压	动词
其他 其它  其余	代词
奇观 壮观	名词
企图 妄图 妄想	动词
企望 希望	动词 名词
启迪 启发 启示	动词
启用 起用	动词
气概 气派 气魄 气势	名词
气候 天气	名词
气味 气息	名词
憩息 歇憩 歇息 休憩 休息	动词
千万 万万	副词 数词，
迁徙 迁移	动词
谦虚 谦逊 虚心	形容词
前辈 先辈 长辈	名词
前程 前途	名词
前言 序 叙  序文 叙文  序言 叙言	名词
前兆 先兆 预兆 兆头 朕兆 征候 征象 征兆	名词
浅薄 浅陋	形容词
浅近 浅显 浅易	形容词
强大 壮大	形容词
强制 强迫	动词
侵犯 侵害 侵略 侵占	动词
侵入 入侵	动词
侵吞 贪污 中饱	动词
亲近 亲密 亲昵 亲切 亲热	形容词
勤奋 勤谨 勤恳 勤快 勤劳 勤勉 勤黾	形容词
轻薄 轻浮 轻狂 轻佻	形容词
轻捷 轻快	形容词
轻蔑 轻视	动词
轻易 容易	形容词
倾诉 倾吐	动词
倾泻 倾注	动词
清除 扫除	动词
清脆 清亮	形容词
情感 情绪	名词
情况 情形 状况	名词
情势 形势	名词
情义 情谊 情意	名词
情意 心意	名词
请教 请示	动词
请求 要求	动词 名词
庆贺 庆祝 祝贺	动词
曲解 歪曲	动词
屈从 屈服 屈伏	动词
趋势 趋向	名词
权力 权利	名词
全部 整个	形容词
泉源 源泉	名词
缺乏 缺少	动词
确切 确实 确凿	形容词
染料 颜料 颜色	名词
让步 退让 妥协	动词
热忱 热诚 热情 热心	形容词 名词，
人间 世间	名词
仁慈 善良	形容词
忍耐 忍受	动词
认为 以为	动词
任务 使命	名词
任性 随便	形容词
仍旧 仍然 依旧 依然	副词
日记 日志	名词
荣幸 幸运	形容词
溶化 溶解 熔化 熔解 融化 融解	动词
柔和 柔软	形容词
知何 怎么	代词
撒波 撒野	动词
杀害 杀戮 屠戮 屠杀	动词
删节 删略	动词
煽动 扇动  怂恿	动词
闪烁 闪耀	动词
擅长 善于 擅于	动词
伤害 损害 危害	动词
商量 商榷 商讨 商议 协商	动词
上当 受编	动词
奢侈 奢华 奢靡	形容词
设备 装备	名词
申明 声明	动词
深奥 深邃 深远	形容词
深刻 深入	形容词
神气 神情 神色 神态	名词
神速 迅速	形容词
神勇 骁勇 英勇 勇敢	形容词
慎重 郑重 庄重	形容词
生命 性命	名词
生气 朝气	名词
声言 扬言	动词
失口 失言 走嘴	动词
十足 实足	形容词
时候 时间 时刻	名词
时兴 时行	动词
实际 实践	名词
实现 完成	动词
拾掇 收拾	动词
食品 食物	名词
使唤 使用 应用 运用	动词
事变 事件	名词
收成 收获	动词 名词
收购 收买	动词
收集 收罗 搜集 搜罗	动词
首相 元首 总理 总统	名词
首要 重要 主要	形容词
瘦削 消瘦	形容词
书 书籍	名词
舒畅 舒服 舒适 舒坦	形容词
熟识 熟悉 熟习	动词
束缚 约束	动词
树立 竖立	动词
数量 数目	名词
耍弄 玩弄 戏弄 捉弄 作弄	动词
顺  沿	介词
顺当 顺利	形容词
思考 思索	动词
松散 松懈	形容词
搜查 搜索 搜寻	动词
夙愿 宿愿  素愿	名词
素养 修养	名词
虽 虽然 虽说 虽则	连词
随处 随地	副词
所以 因此 因而	连词
琐碎 琐细 琐屑	形容词
贪婪 贪心	形容词
谈论 议论	动词
坦率 直率 直爽	形容词
陶冶 熏陶	动词
讨论 议论	动词
讨厌 厌烦 厌恶 僧恶	动词
特别 特殊 特异	形容词
特别 尤其	副词
特地 特为 特意	副词
特点 特色 特性 特征 特质	名词
疼  痛	形容词
疼爱 心疼	动词
体会 体味 体验	动词
体系 系统	名词
天才 英才	名词
挑刺儿 挑剔 挑眼	动词
调和 调解 调停	动词
调剂 调节 调整	动词
调皮 顽皮	形容词
挑衅 挑战	动词
铁道 铁路	名词
停顿 停留 停止 停滞 中止	动词
通信 通讯	动词
同意 赞成	动词
投合 迎合	动词
透亮 透明	形容词
图谋 阴谋 预谋	动词
推迟 推后 推延 延迟	动词
推辞 推却 推托 推讬  推脱 推卸	动词
推戴 拥戴	动词
推动 推进	动词
推广 推行	动词
推荐 推举 推选	动词
推敲 斟酌	动词
退缩 畏缩	动词
吞没 淹没	动词
拖拉 拖沓	形容词
脱节 脱离	动词
妥当 妥善 妥帖	形容词
挖苦 奚落	动词
完备 完美 完善	形容词
完全 完整	形容词
挽回 挽救	动词
婉转 宛转  委婉 委宛	形容词
忘掉 忘怀 忘记 忘却 遗忘	动词
旺盛 兴旺	形容词
危急 危险	形容词
威逼 威吓 威迫 威胁 要胁 要挟	动词
威望 威信	名词
威严 庄严	形容词
微细 微小 细微 细小	形容词
巍峨 巍然 巍巍	形容词
位置 位子	名词
味道 滋味	名词
慰劳 慰问	动词
温存 温和 温柔 温顺	形容词
文豪 文人 作家	名词
文明 文雅	形容词
稳定 稳固	形容词 动词
污蔑 诬蔑	动词
污辱 侮辱	动词
诬告 诬陷	动词
无聊 无谓	形容词
无穷 无限	形容词
物质 物资	名词
误会 误解	动词 名词
稀罕 希罕  稀奇 希奇	形容词
习惯 习气 习性	名词
细密 细心 细致 周密 仔细	形容词
狭隘 狭窄	形容词
遐想 遥想	动词
下贱 下流 下作	形容词
下落 着落	名词
贤惠 贤慧  贤淑	形容词
贤明 英明	形容词
限定 限制	动词
相称 相当	形容词
相干 相关	动词
相信 信赖 信任	动词
详尽 详细	形容词
降服 征服	动词
享乐 享受	动词
享年 终年	名词
像片 相片  照片	名词
消除 消灭	动词
消灭 消失 消逝 消亡	动词
消息 新闻	名词
消息 信儿 信息 音问 音信 音讯	名词
萧索 萧条	形容词
晓得 知道 知悉 知晓	动词
效率 效益	名词
协定 协议	名词
邪道 邪路 斜路	名词
泄劲 懈劲  泄气 懈气	动词
泄漏 泄露 走漏 走露	动词
心境 心情 心绪	名词
心思 心意	名词
辛苦 辛劳 辛勤	形容词
新奇 新鲜 新颖	形容词
信奉 信仰	动词
信函 信件 信札	名词
兴建 兴修	动词
行李 行囊 行装	名词
形状 样子	名词
省悟 醒悟	动词
兴会 兴趣 兴味 兴致	名词
幸而 幸好 幸亏	副词
性格 性情	名词
凶暴 凶残 凶恶 凶狠 凶横	形容词
凶恶 狰狞	形容词
修理 修葺 修缮	动词
羞惭 羞愧	形容词
羞怯  羞涩	形容词
虚假 虚伪	形容词
需要 须要	动词
畜养  蓄养	动词
宣传  宣扬	动词
喧哗  喧闹	形容词 动词
喧嚷 喧嚣	动词
选集  选辑	名词
寻觅 寻找 找寻	动词
寻求  追求	动词
巡查  巡视	动词
驯服  制服 制伏、治服	动词
压抑  压制	动词
延长 延伸 延展	动词
严格 严厉	形容词
严峻 严酷  严厉	形容词
严肃  严正	形容词
研究  钻研	动词
掩蔽 掩藏	动词
掩盖 掩饰	动词
仰望 瞻仰	动词
样  种	量词
邀请  约请	动词
摇摆  摇荡  摇动  摇晃  摇曳	动词
一概  一律	副词
一贯  一向  一直	副词
一齐 一起	副词
一样  一致	形容词
依靠 依赖 倚靠 倚赖 仰赖 指靠	动词
依稀  隐约	形容词
以后  以来	方位名词
以至  以致	连词
义务  责任	名词
抑郁  忧郁	形容词
意  义	名词
意思  意义	名词
意志  毅力	名词
因为  由于	介词 连词
阴沉 阴森	形容词
荫蔽 隐蔽 隐藏	动词
引用  引证	动词
应当  应该	助动词
英豪  英雄	名词
英俊 英武	形容词
营建  营造	动词
勇士 壮士	名词
用场  用处  用途	名词
忧愁  忧郁	形容词
油滑  圆滑	形容词
游逛  游览  游历	动词
友情  友谊	名词
幼小  幼稚	形容词
愚蠢  愚昧	形容词
语义 语意	名词
预报 预告	动词 名词
预备  准备	动词
预订  预定  预约	动词
遇到  遭到  遭逢  遭受  遭遇	动词
援助 支持 支援	动词
缘故 原故   原因	名词
灾害  灾患  灾荒  灾祸  灾难  灾殃	名词
赞成  赞助	动词
赞美 赞赏 赞叹 赞扬	动词
责备 责怪 责难	动词
责问 质问	动词
择要 摘要	动词
怎么  怎样	疑问代词
增加  增添	动词
占据  占领	动词
战斗 战役 战争	名词
战略 战术	名词
召集  召开	动词
遮蔽 遮盖 遮掩	动词
折腾 折磨	动词
这么  这样	代词
侦查  侦察	动词
珍爱 珍视 珍惜 珍重	动词
真诚  真挚	形容词
真切 真确	形容词
震荡 振动 震动 震撼	动词
整顿  整理	动词
正派  正直	形容词
正确  准确	形容词
证明  证实	动词
支撑  支持	动词
支使 指派 指使	动词
只要 只有	连词
指导 指挥 指引	动词
指点 指教 指示	动词
志愿  自愿	动词
制定  制订	动词
制造 制作	动词
忠诚  忠实	形容词
终究  终于	副词
终身  终生	名词
周到  周全	形容词
主动  自动	形容词
主见 主意 主张	名词
注解  注释	动词 名词
转变 转化 转移	动词
追查  追究	动词
姿势  姿态	名词
踪迹  踪影	名词
阻碍  阻挡  阻拦  阻挠  阻止	动词
罪恶  罪过  罪孽  罪行  罪责	名词
遵从 遵循 遵照	动词
尊敬 尊重	动词
作 做	动词
作法 做法	名词 动词
引发 铺垫 引出	动词
本文 下文	名词
议论 论述	动词
深厚 密切 紧密 坚固	形容词
勤奋 努力	形容词
论证 证明	动词
举例 事例 例子	跨词性
引发 引起	动词
砍伐 砍料	动词
王荆公 荆公 王安石	名词
论点 观点	名词
信守 守信 承诺	名词
说话算法 说到做到	成语
情节 线索	名词
